1111111111111111
1000000000000000
1000000000000000
1000000000000000
1200000000000000
1222000000000000
1222222000000000
1222222200000000
1111111111110000