1111111111111111
1110000000000000
1000000000000000
1000000000000000
1200002222220000
1222000000000000
1222222000000000
1222222200000000
1111111111110000