1111111111111111111111111
1333333333333333333333331
1333333333333333333333331
1333333333333333333333331
1333333333333333333333331
1333000000333333000000331
1333004000333333000040331
1333000000333333000000331
1333400000333333040000331
1222222222333333222222221
1000000000000000000000001
1000000040000000000000001
1222222222333333222222221
1333333333333333333333331
1333333333333333333333331
1333333333333333333333331
1333322222222222222233331
1400000000000000000000041
1000000040000000000000001
1400000000000000000000001
1000000000000040000000401
1040000000000000000000001
1000000000000000000000001
1222222222222222222222221
1222222222222222222222221